0x00000000 0x61626380 0x00000000 0x00000000 0x00000000
0x00000010 0x00000000 0x00000000 0x00000000 0x00000000
0x00000020 0x00000000 0x00000000 0x00000000 0x00000000
0x00000030 0x00000000 0x00000000 0x00000000 0x00000018
0x00000040 0x61626380 0x00000000 0x00000000 0x00000000
0x00000050 0x00000000 0x00000000 0x00000000 0x00000000
0x00000060 0x00000000 0x00000000 0x00000000 0x00000000
0x00000070 0x00000000 0x00000000 0x00000000 0x00000018